381 1
5 10 20 100
1 20 0 1
1 20 2 1
1 20 4 1
1 20 6 1
1 20 8 1
1 20 10 1
1 20 12 1
1 20 14 1
1 20 16 1
1 20 18 1
1 20 20 1
1 20 22 1
1 20 24 1
1 20 26 1
1 20 28 1
1 20 30 1
1 20 32 1
1 20 34 1
1 20 36 1
1 21 1 1
1 21 3 1
1 21 5 1
1 21 7 1
1 21 9 1
1 21 11 1
1 21 13 1
1 21 15 1
1 21 17 1
1 21 19 1
1 21 21 1
1 21 23 1
1 21 25 1
1 21 27 1
1 21 29 1
1 21 31 1
1 21 33 1
1 21 35 1
1 21 37 1
1 22 0 1
1 22 2 1
1 22 4 1
1 22 6 1
1 22 8 1
1 22 10 1
1 22 12 1
1 22 14 1
1 22 16 1
1 22 18 1
1 22 20 1
1 22 22 1
1 22 24 1
1 22 26 1
1 22 28 1
1 22 30 1
1 22 32 1
1 22 34 1
1 22 36 1
1 23 1 1
1 23 3 1
1 23 5 1
1 23 7 1
1 23 9 1
1 23 11 1
1 23 13 1
1 23 15 1
1 23 17 1
1 23 19 1
1 23 21 1
1 23 23 1
1 23 25 1
1 23 27 1
1 23 29 1
1 23 31 1
1 23 33 1
1 23 35 1
1 23 37 1
1 24 0 1
1 24 2 1
1 24 4 1
1 24 6 1
1 24 8 1
1 24 10 1
1 24 12 1
1 24 14 1
1 24 16 1
1 24 18 1
1 24 20 1
1 24 22 1
1 24 24 1
1 24 26 1
1 24 28 1
1 24 30 1
1 24 32 1
1 24 34 1
1 24 36 1
1 25 1 1
1 25 3 1
1 25 5 1
1 25 7 1
1 25 9 1
1 25 11 1
1 25 13 1
1 25 15 1
1 25 17 1
1 25 19 1
1 25 21 1
1 25 23 1
1 25 25 1
1 25 27 1
1 25 29 1
1 25 31 1
1 25 33 1
1 25 35 1
1 25 37 1
1 26 0 1
1 26 2 1
1 26 4 1
1 26 6 1
1 26 8 1
1 26 10 1
1 26 12 1
1 26 14 1
1 26 16 1
1 26 18 1
1 26 20 1
1 26 22 1
1 26 24 1
1 26 26 1
1 26 28 1
1 26 30 1
1 26 32 1
1 26 34 1
1 26 36 1
1 27 1 1
1 27 3 1
1 27 5 1
1 27 7 1
1 27 9 1
1 27 11 1
1 27 13 1
1 27 15 1
1 27 17 1
1 27 19 1
1 27 21 1
1 27 23 1
1 27 25 1
1 27 27 1
1 27 29 1
1 27 31 1
1 27 33 1
1 27 35 1
1 27 37 1
1 28 0 1
1 28 2 1
1 28 4 1
1 28 6 1
1 28 8 1
1 28 10 1
1 28 12 1
1 28 14 1
1 28 16 1
1 28 18 1
1 28 20 1
1 28 22 1
1 28 24 1
1 28 26 1
1 28 28 1
1 28 30 1
1 28 32 1
1 28 34 1
1 28 36 1
1 29 1 1
1 29 3 1
1 29 5 1
1 29 7 1
1 29 9 1
1 29 11 1
1 29 13 1
1 29 15 1
1 29 17 1
1 29 19 1
1 29 21 1
1 29 23 1
1 29 25 1
1 29 27 1
1 29 29 1
1 29 31 1
1 29 33 1
1 29 35 1
1 29 37 1
1 30 0 1
1 30 2 1
1 30 4 1
1 30 6 1
1 30 8 1
1 30 10 1
1 30 12 1
1 30 14 1
1 30 16 1
1 30 18 1
1 30 20 1
1 30 22 1
1 30 24 1
1 30 26 1
1 30 28 1
1 30 30 1
1 30 32 1
1 30 34 1
1 30 36 1
1 31 1 1
1 31 3 1
1 31 5 1
1 31 7 1
1 31 9 1
1 31 11 1
1 31 13 1
1 31 15 1
1 31 17 1
1 31 19 1
1 31 21 1
1 31 23 1
1 31 25 1
1 31 27 1
1 31 29 1
1 31 31 1
1 31 33 1
1 31 35 1
1 31 37 1
1 32 0 1
1 32 2 1
1 32 4 1
1 32 6 1
1 32 8 1
1 32 10 1
1 32 12 1
1 32 14 1
1 32 16 1
1 32 18 1
1 32 20 1
1 32 22 1
1 32 24 1
1 32 26 1
1 32 28 1
1 32 30 1
1 32 32 1
1 32 34 1
1 32 36 1
1 33 1 1
1 33 3 1
1 33 5 1
1 33 7 1
1 33 9 1
1 33 11 1
1 33 13 1
1 33 15 1
1 33 17 1
1 33 19 1
1 33 21 1
1 33 23 1
1 33 25 1
1 33 27 1
1 33 29 1
1 33 31 1
1 33 33 1
1 33 35 1
1 33 37 1
1 34 0 1
1 34 2 1
1 34 4 1
1 34 6 1
1 34 8 1
1 34 10 1
1 34 12 1
1 34 14 1
1 34 16 1
1 34 18 1
1 34 20 1
1 34 22 1
1 34 24 1
1 34 26 1
1 34 28 1
1 34 30 1
1 34 32 1
1 34 34 1
1 34 36 1
1 35 1 1
1 35 3 1
1 35 5 1
1 35 7 1
1 35 9 1
1 35 11 1
1 35 13 1
1 35 15 1
1 35 17 1
1 35 19 1
1 35 21 1
1 35 23 1
1 35 25 1
1 35 27 1
1 35 29 1
1 35 31 1
1 35 33 1
1 35 35 1
1 35 37 1
1 36 0 1
1 36 2 1
1 36 4 1
1 36 6 1
1 36 8 1
1 36 10 1
1 36 12 1
1 36 14 1
1 36 16 1
1 36 18 1
1 36 20 1
1 36 22 1
1 36 24 1
1 36 26 1
1 36 28 1
1 36 30 1
1 36 32 1
1 36 34 1
1 36 36 1
1 37 1 1
1 37 3 1
1 37 5 1
1 37 7 1
1 37 9 1
1 37 11 1
1 37 13 1
1 37 15 1
1 37 17 1
1 37 19 1
1 37 21 1
1 37 23 1
1 37 25 1
1 37 27 1
1 37 29 1
1 37 31 1
1 37 33 1
1 37 35 1
1 37 37 1
1 38 0 1
1 38 2 1
1 38 4 1
1 38 6 1
1 38 8 1
1 38 10 1
1 38 12 1
1 38 14 1
1 38 16 1
1 38 18 1
1 38 20 1
1 38 22 1
1 38 24 1
1 38 26 1
1 38 28 1
1 38 30 1
1 38 32 1
1 38 34 1
1 38 36 1
1 39 1 1
1 39 3 1
1 39 5 1
1 39 7 1
1 39 9 1
1 39 11 1
1 39 13 1
1 39 15 1
1 39 17 1
1 39 19 1
1 39 21 1
1 39 23 1
1 39 25 1
1 39 27 1
1 39 29 1
1 39 31 1
1 39 33 1
1 39 35 1
1 39 37 1
1 2 5 20
